11 11
%%%%%%%%%%%
S %       %
% % %%%%% %
% % %   % %
% % % % %%%
% %   %   %
% %%%%%%% %
% % %     %
% % % % %%%
%         E
%%%%%%%%%%%
